page=Page
content=Bienvenue sur la page
products=Produits
home=Home
contact=Contact
impressum=Impressum
agb=CG
contactContent=Pour toutes questions envoiez nous un email avec nôtre formulaire.
firstName=Prénom
lastName=Nom
contactComment=Commentaire
submit=Envoyer
FormFirstNameError=Entrez votre Prénom
FormLastNameError=Entez votre Nom.
FormEmailError=Email erroné
FormCommentError=Ajoutez un commentaire
successMail=L'email à été envoyé avec succes
productBuy=Acheter
accNeeded=Vous devez être connecter
allReadyLogged=Vous êtes déjà connecté
account=Compte
backend=Gestion
addBeer=Ajouter une bière
beerName=Nom de Bière [DE]
typeOfBeer=Catégorie
brand=Marque
beerPrice=Prix
imgSrc=Source de l'image
alcPercent=alcool [%]
energy=Energie
addTypeOfBeer=Ajouter une catégorie
typeName=Nom de catégorie
password=Mot de Passe
changePassword=Modifier le MDP
street=Rue
city=Ville
error_1=Le Nom d'utilisateur ou le Mot de passe est incorrect!
articleName=Nom&nbsp;des&nbsp;Produits
articleNum=Nombre
checkout=Panier d'achat
gotoCheckout=Passer en caisse
removeType=Supprimer une catégorie
addBeer=Ajouter une Bière
removeProduct=Supprimer une Bière
removeBrand=Supprimer une Marque
addBrand=Ajouter une Marque
brandName=Nom de la Marque
beerNameFR=Nom de Bière [FR]
login=Login
error_11=Vérifiez vos données.
error_12=Cette adresse email est déjà enregistré.
success_2=Vous vous êtes connecté correctement.
showUsers=Afficher les utilisateurs
addresses=Afficher les adresses
logindata=Données de Login
userdata=données d'utilisateur
address=Adresse
birthdate=Date de naissance
zipcode=NPA
town=Ville
register=Créer un Compte
email=Email
password_retype=re-tapez le Mot de passe
plz=NPA
