page=Seite
content=Willkommen auf der Seite
products=Produkte
contact=Kontakt
home=Home
impressum=Impressum
agb=AGB
contactContent=Für allfällige fragen schicken sie uns doch ein email mit unserem Email formular !
firstName=Vorname
lastName=Nachname
contactComment=Kommentar
submit=Schicken
FormFirstNameError=Geben sie bitte ihr Vorname ein.
FormLastNameError=Geben sie bitte ihr Nachname ein.
FormEmailError=Ungültige Email
FormCommentError=Schreiben sie doch ein kommentar
successMail=Das Email wurde erfolgreich gesendet
productBuy=Kaufen
accNeeded=Sie müssen eingeloggt sein.
allReadyLogged=Sie sind bereits eingeloggt.
account=Account
backend=Verwaltung
addBeer=Bier Hinzufügen
beerName=Bier Name
typeOfBeer=Kategorie
brand=Marke
beerPrice=Preis
imgSrc=Bild source
alcPercent=alcohol [%]
energy=Energie
addTypeOfBeer=Kategorie Hinzufügen
typeName=Kategorie Name
password=Passwort
changePassword=Passwort ändern
street=Strasse
city=Stadt
